111111111111111111111111111111111
1CCCCCCCCCCCCCCCCCCCCCCCCC00C0001
10000000001CCCCCCCCCCCCCCCCCCC001
100000000C0000C000000000100000001
100000000010000000000000000000001
10000000001CCCCCCCCCCCCCCCCCCC001
100P01000010000100000000000000001
100000000010000000000000100000001
1CCCCCCCCCC00000000CCCCCCC00C0001
10000000001CCCCCCCCCCCCCCCCCCC001
100000000C0000C000000000100000001
100000000010000000000000000000001
10000000001CCCCCCCCCCCCCCCCCCC001
100000000010000000000000000000001
100000000010000000000000000000001
100000000010000000000000000000001
100000000010000000000000000000001
10000000001000000000000000000E001
111111111111111111111111111111111